P P P E P P P P P P P P P P P P P P 
P P V P P P V P P P V P P P V P P P 
P L V L P L V L P L V L P L V L P P 
P V V V V V V V V V V V V V V V V P 
P L V L P L V L P L V L P L V L P P 
P P V P P P V P P P V P P P V P P P 
P L V L P L V L P L V L P L V L P P 
P V V V V V V V V V V V V V V V V P 
P L V L P L V L P L V L P L V L P P 
P P V P P P V P P P V P P P V P P P 
P L V L P L V L P L V L P L V L P P 
P V V V V V V V V V V V V V V V V P 
P L V L P L V L P L V L P L V L P P 
P P V P P P V P P P V P P P V P P P 
P L V L P L V L P L V L P L V L P P 
P V V V V V V V V V V V V V V V V P 
P L V L P L V L P L V L P L V L P P 
P P V P P P V P P P V P P P V P P P 
P L V L P L V L P L V L P L V L P P 
P V V V V V V V V V V V V V V V V P 
P L V L P L V L P L V L P L V L P P 
P P P P P P P P P P P P P P S P P P 
